wwwwwwwwwwwwwwwww
wYw0wQQQw0wUw*//w
wQw3wQwQwQw5w.//w
wQw!w5wEwQwUw8//w
wQwQwQwQwQwQwwwww
w^w^wIw^wEw^w///w
wQEQ@QEQQQQQwwwww
w^w^w^w^wEw^w///w
wQwQwQwQwQwQwwwww
wQwQw!w5wKwQw///w
wUwUwQw@wQwQwwwww
wQ5QwQwKwQw+w///w
wwwwwwwwwwwwwwwww
